
NO ./651651651sdcdcdscsdcdscdscdscdscdscdscds    
SO ./images/image1.jpgsdcdcdscsdcdscdscdscdscdscdscds
WE ./images/image1.jpgsdcdcdscsdcdscdscdscdscdscdscds
EA ./images/image1.jpgsdcdcdscsdcdscdscdscdscdscdscds 

F 220,   100 ,   2 
C 225,30,0


1111111111111111
1000000001000001
1000000001000001
1000010001001001
1000000001000001
1000000N00001111
1000000000000001
1111111111111111