NO ./img/wall2.xpm
SO ./img/wall2.xpm
WE ./img/wall4.xpm
EA ./img/wall4.xpm

F 96,185,34
C 135,206,235

        1111111111111111111111111                1
        1000000000110000000000001                1
        1011000001110000000000001                1
        1001000000000000000000001                1
111111111011000001110000000000001                1
100000000011000001110111111111111                1
11110111111111011100000010001
11110111111111011101010010001
110000001101010111000000000011
 100000000000000001100000010001
100000000000000011010100100011
11000001110101011111011110N0111
11110111 1110101 101111010001
11111111 1111111 111111111111