NO ./img/wall1.xpm
SO ./img/wall1.xpm
WE ./img/wall1.xpm
EA ./img/wall1.xpm

F 96,185,34
C 135,206,235

11111111111
10000000001
10010001001
101N0000101
10010001001
10000000001
11111111111