NO ./img/wall1.xpm
SO ./img/wall1.xpm
WE ./img/wall1.xpm
EA ./img/wall1.xpm

F 96,185,34
C 135,206,235

                                     1111111111111111
        1111111111111111111111111111110000000000000001
        1000000000110000000000001111110000000000000001
        1011000001110000000000001111110000000000000001
        1001000000000000000000001111111100000000011111
111111111000000000000000000000000000000000000000001                1
100000000000000000000000000000000000000001111111111                1
11110111110000000000000000000000000000000010001
11110111110000000000000000000000000000000010001
110000001100000000000000000000000000000000000011
 100000100000000000000000000000000000000000010001
100000000000000000000000000000000000000000100011
1100000111010101111101110N011111111111111111111
11110111 1110101 101111010001
11111111 1111111 111111111111        1111111111111111            1111111111111111
        1111111111111111111111111111110000000000000001
        1000000000110000000000001111110000000000000001
        1011000001110000000000001111110000000000000001
        1001000000000000000000001111111100000000011111
111111111000000000000000000000000000000000000000001                1
100000000000000000000000000000000000000001111111111                1
11110111110000000000000000000000000000000010001
11110111110000000000000000000000000000000010001
110000001100000000000000000000000000000000000011
 100000100000000000000000000000000000000000010001
100000000000000000000000000000000000000000100011
11000001110101011111011100011111111111111111111
11110111 1110101 101111010001
11111111 1111111 111111111111        1111111111111111            1111111111111111
        1111111111111111111111111111110000000000000001
        1000000000110000000000001111110000000000000001
        1011000001110000000000001111110000000000000001
        1001000000000000000000001111111100000000011111
111111111000000000000000000000000000000000000000001                1
100000000000000000000000000000000000000001111111111                1
11110111110000000000000000000000000000000010001
11110111110000000000000000000000000000000010001
110000001100000000000000000000000000000000000011
 100000100000000000000000000000000000000000010001
100000000000000000000000000000000000000000100011
11000001110101011111011100011111111111111111111
11110111 1110101 101111010001
11111111 1111111 111111111111         1111111111111111             1111111111111111
        1111111111111111111111111111110000000000000001
        1000000000110000000000001111110000000000000001
        1011000001110000000000001111110000000000000001
        1001000000000000000000001111111100000000011111
111111111000000000000000000000000000000000000000001                1
100000000000000000000000000000000000000001111111111                1
11110111110000000000000000000000000000000010001
11110111110000000000000000000000000000000010001
110000001100000000000000000000000000000000000011
 100000100000000000000000000000000000000000010001
100000000000000000000000000000000000000000100011
11000001110101011111011100011111111111111111111
11110111 1110101 101111010001
11111111 1111111 111111111111
                                     1111111111111111
        1111111111111111111111111111110000000000000001
        1000000000110000000000001111110000000000000001
        1011000001110000000000001111110000000000000001
        1001000000000000000000001111111100000000011111
111111111000000000000000000000000000000000000000001                1
100000000000000000000000000000000000000001111111111                1
11110111110000000000000000000000000000000010001
11110111110000000000000000000000000000000010001
110000001100000000000000000000000000000000000011
 100000100000000000000000000000000000000000010001
100000000000000000000000000000000000000000100011
11000001110101011111011100011111111111111111111
11110111 1110101 101111010001
11111111 1111111 111111111111