NO ./img/wall2.xpm
SO ./img/wall2.xpm
WE ./img/wall4.xpm
EA ./img/wall4.xpm

F 96,185,34
C 135,206,235

        1111111111111111111111111
        1000000000110000000000001
        1011000001110000000000001
        1001000000000000000000001
111111111011000001110000000000001
100000000011000001110111111111111
11110111111111011100000010001
11110111111111011101010010001
11000000110101011100000000001
10000000000000001100000000001
10000000000000001101010000001
11000001110101011111011100N0111
11110111 1110101 111111110001
11111111 1111111 111111111111